####   !   #
#  #       #
# +   !    #
       @   #
  +    /    
#        # @
# +   !    #
######     D
1
####   !   #
#  #       #
# +   !    #
       @   #
  +    /    
#        # @
2