####   !   #
#  #       #
#     !    #
       @   #
        /   
#        # @
#     !    #
######     D