###############
# @ @@ @@@ /  #
#@#!# # # # # #
#@ @ @@ @ @  @#
# #@# #!# #@#@#
#@@@! @ @ @   #
# # # # # # # #
#@D@ @ @@@@!  #
###############
1-9-0
#############
# @  @ @@@ /#
#@#!# # # # #
#@ @ @@ @ @ #
# #@# #!# #@#
#@@@! @ @ @ #
# # # # # # #
#!D@ @ @@@@!#
#############
2-7-150
#####################
# @ @@ @@@ @@ !@  / #
#@#!# # # # # # # # #
#@ @ @@ @ @! @ !@@@ #
# #@# #!#@#@#@# # #@#
#@@@! @ @@@  ! @@@ @#
# # # # # # # # # # #
#@D  @  ! @!@ @@ @ @#
#####################
3-5-100