@@@@@@@@@@@@
    #      @
@@@@@@@@@@@@
 #        # 
@@@@@@@@@@@@
/          D
0-20-0
############
#/         #
#     !    #
       @   #
            
#        # @
#     !    #
######     D
1-20-0
############
#  #       #
# +#  !    #
       @   #
  +    /    
#        # @
# +   !   D#
############
2-20-10
############
#  #       #
# +#  !    #
       @   #
  +    /    
#     D#####
3-5-200