####   !   #
#  #       #
# +   !    #
       @   #
  +    /    
#        # @
# +   !    #
######     D
1-200-4-5
############
#  #       #
# +#  !    #
       @   #
  +    /    
#        # @
# +   !   D#
############
2-200-4-5