####   !   #
#  #       #
#     /    #
 !     @   #

#        # @
#     !    #
######     D