####   !   #
#  #       #
#     !    #
 /     @   #

#        # @
#     !    #
######     D